16 10 8
##########
#        #
# ###### #
# #    # #
# # ## # #
# # ## # #
# # ## # #
# # ## # #
# ###### #
# #      #
# # ## ###
# # #    #
# #    # #
# ## ### #
#        #
##########