13 21 4
#####################
#                   #
#    ################
#                   #
#### ################
####             ####
####    #############
####             ####
###############  ####
#    #              #
#    ###########    #
#                   #
#####################
