15 10 4
##########
#        #
# #### # #
# #    # #
# # ## # #
# # ## # #
# # ## # #
# # #### #
# #      #
# # ## ###
# ###    #
# #  # # #
# ##v### #
#   #    #
##########