13 21 8
#####################
#                   #
#    ############## #
#                   #
#### ########## #####
####             ####
####    #############
####             ####
###############  ####
#                   #
#    ###########    #
#                   #
#####################
