15 31 2
###############################
#                             #
# ########################### #
#                           # #
# ######################### # #
# #                       # # #
# # ################### # # # #
# # #                   # # # #
# # #  ################## # # #
# # #                     # # #
# # ####################### # #
# #                         # #
# ########################### #
#                             #
###############################