15 31 2
###############################
#                             #
# ########################### #
#                           # #
# ######################### # #
# #                *      # # #
# # ###################v# # # #
# # #                   # # # #
# # #  ################## # # #
# # #                     # # #
#v# ####################### # #
# #                         # #
# ########################### #
#                             #
###############################